10
10
-+--+-++-+
--+--+-++-
++--+-++-+
-+--+-++-+
-+--+-++-+
-+--+-++-+
-+--+-++-+
-+--+-++-+
-+--+-++-+
-+--+-++-+
